########
#  .  @#
#  $  ##
#      #
########
