#################
# .       .     #
#   #######     #
# $ #     # $   #
#   #  $  #     #
### #  #  # #####
#   $  @  $     #
#   #######     #
# .       .     #
#################
