###############
#     .       #
#  $     $    #
#   ### ###   #
#  $  @  $    #
#   ### ###   #
#  $     $    #
#     .       #
###############