###########
#   .     #
# $ # $ # #
#   #   # #
### ### ###
#   @     #
### ### ###
#   #   # #
# $ # $ # #
#     .   #
###########