#######
#     #
#.$@$.#
#     #
#######