###############
# .         . #
#    ###      #
#  $     #    #
## ######  ####
#          $  #
#   #######   #
#   #     #   #
#  $  @  $    #
###############