#########
#   .   #
# $   $ #
#   @   #
# $   $ #
#   .   #
#########
